##################################################
#                                                #
####                                             #
# ^        @                                     #
#####~~~~#########################################