##################################################
#                                                #
#                                                #
#                                                #
#                                                #
#                                                #
# ^        @                                     #
##################################################