#########################
#          @#           #
# ###########           #
#                       #
######### ###           #
# ^         #~~~~~~~~~~~#
#########################