##################################################
#                                                #
####                                             #
# ^        @                                     #
##################################################