###########################################################
#############  #######   ##################################
########                             #            #########
######## ########   ### #                  #### #####     #
###      ############   ##        #### #####      ### #####
### ###########         #     ##     #    #~~~~~~~###    @#
#                       #  #         #    ############# ###
###### ######           #            #            #       #
# ^         #~~~~~~~~~~~#~~~~~~~~~~~~#                  #~#
###########################################################