#############################################################
#############  #######   ####################################
########                             #            ###########
######## ########   ### #                  #### #####    @###
###      ######### ##   ##        #### #####      ### #######
### ###########         #     ##     #    #~~~~~~~###       #
#                       #  #         #    ##############  # #
###### ######           #            #            #      ## #
# ^         #~~~~~~~~~~~#~~~~~~~~~~~~#                  ###~#
#############################################################