###########################################################
########                             #            #########
######## ############## #                  #### ###########
###      ############   ##        #### #####      #########
### ###########         #     ##     #    #~~~~~~~##### ###
#                       #  #         #    ############# ###
###### ######           #            #            #       #
# ^         #~~~~~~~~~~~#~~~~~~~~~~~~#                    #
###########################################################