#############################################################
#############  #######   ####################################
########                             #            ###########
######## ########   ### #                  #### #####    @###
###      ############   ##        #### #####      ### #######
### ###########         #     ##     #    #~~~~~~~###       #
#                       #  #         #    ##############  # #
###### ######           #            #            #      ## #
# ^         #~~~~~~~~~~~#~~~~~~~~~~~~#                  ###~#
#############################################################