###########################################################
########                             #            #########
######## ############## #                  #### #####     #
###      ############   ##        #### #####      ### #####
### ###########         #     ##     #    #~~~~~~~###    @#
#                       #  #         #    ############# ###
###### ######           #            #            #       #
# ^         #~~~~~~~~~~~#~~~~~~~~~~~~#                  #~#
###########################################################