########################
#               #     @#
#               ## #####
# ^                    #
####~#~#~#~#~#~#########