###########################################################################
################## !!!!!!!!!!              ################################
################################### ###### ###            #################
######################            #^###### ### ########## #################
############################# ############           #### ####       ######
############################# ##################### ##### #### ##### ######
############################# ##      ###        ## ##### #    ####  ######
############################# ####### ### ## ###    ##### ######### #######
############################# ####### ### ## ############     #####      ##
############################# #####       ## ########################### ##
############################# ############## #########################   ##
##################            ##############                           ####
##################            ############## #########################@####
###########################################################################